.#.#########.###########.#######.#####.#.
# #         #           #       #     # #
# # # ##### ##### ##### # ##### ### # # #
# # #     #       #   # #     #     # # #
# # ##### # ####### # # ##### ####### # #
#   # #   # #     # # #     #   #     # #
# ### # ### # ### # # ##### ### # ##### #
# #   # #   #   # # #     # #   #   #   #
# ### # ##### ### ####### # # ##### ### #
#     # #     #   #       #   #   #     #
.#### # # ##### ### ########### ####### #
#   # #   #   #   #   #             #   #
# ### ##### # ### # # # ####### # ### ##.
#     #   # # # # # # # #     # #      @#
# ##### # # # # # # # # # ### ######### #
#   #   # # #   # # #   # # #       #   #
.## ### # # ### # ##### # # ####### # ##.
#   #   #   #   # #   # #   # #   # #   #
# ### ######### # # # ##### # # # # ####.
#   # #       # # # #     # #   # #     #
.## # # ##### # # # ### ### ##### ##### #
# # # #     # # #   #S#   # #       # # #
# # # ##### # ####### # # # # ##### # # #
# #   # #   #     #   # #     #   #   # #
# ### # # ####### # ########### # ##### #
# #   # # #     # #           # #       #
# # ### # # ### # ########### # ####### #
# # #   # #   #           #   # #       #
# # # ### ### ############# ### ########.
# # #   #   #     #       #   # #   #   #
# # ### ### ##### # ##### ### # # # # # #
# #       #   # #   #   #   # # # #   # #
# ####### ### # ####### ### # # # ##### #
#       #   #     #       #   # # #o  # #
# ##### # ####### # # ######### # ### # #
#     #   #       # #       #       # # #
.#### ##### ############# # ####### # # #
#   #   #   #   #         # #   #     # #
# # ### # ### # # ######### # # ####### #
# #     #     #   #           #         #
.#.#####.#####.###.###########.#########.
