........................................#########...........#########........
........................................#.......#...........#.......#........
........................................#.......#...........#.......#........
........................................#.......#...........#.......#........
........................................#.......#...........#.......#........
........................................#.......#...........#.......#........
........................................#.......#...........#.......#........
........................................#.......#...........#.......#........
........................................#.......#.......#############........
........................................#.......#.......#...#................
#########...................#############.......#.....^######................
#.......#...................#...................#.......#....................
#.......#...................#...................###########..................
#.......#...................#...........................#.#..................
#.......#...................#...........................#.#..................
#.......#...................#...........................#.#..................
#.......#...................#...........................###########..........
#.......#...................#.............................#.......#..........
###########.................#.............................###########........
........#.#.................#.....................................#.#........
........#.#...........#######.....................................#.#........
........#.#...........#...........................................#.#........
........###########...#...........................................###########
..........#.......#...#.............................................#.......#
..........###########.#.............................................#.......#
..................#.#.#.............................................#.......#
..................#.#.#.............................................#.......#
..................#.#.#.............................................#.......#
..................###########.......................................#.......#
....................#.#.............................................#.......#
................#######.............................................#########
................#...#........................................................
........#############........................................................
........#.......#............................................................
........#.......#............................................................
........#.......#............................................................
........#.......#............................................................
........#.......#............................................................
........#.......#............................................................
........#.......#............................................................
........#########............................................................
